________________________________________________________
________________________________________------------____
_____-------------<5>------_____________-__________-____
_____-_____________v______-_____________^__________^____
_____^_____________---____--<6>--------<7>--------<8____
_____4>---------_____---_____v_____________________v____
_____v_________-----___-_____-_______________-------____
_____-_____________-___-_____-_______________-__________
_____-_____________^___-_____^_______________^__________
_____------<3>----<9>---_____10>------------<11>-----___
____________v________________v______________________-___
____________-________________-_______________________-__
___----------________________-_______________________-__
___-_________________________-_______________________^__
___^_______________________---______________--------<12_
___2>---------<13>-----____^_________--<19>--________v__
___v___________v______----<14>--------__v____________-__
___-___________------___________________-____________-__
___-________________-___________________-----________-__
___-________________^_______________________^________-__
___--------_______-<15>-----------<16>-----<17>--____-__
__________-_______-________________v____________-____-__
__________^_______-________________-____________-____^__
__________1>-------_______----------____________----<18_
__________v_______________-__________________________v__
__________-_______________-__________________________-__
__________-_______________^__________________________-__
__________---------------<0>--------------------------__
________________________________________________________
